NO ./path_to_the_north_texture
SO ./path_to_the_south_texture
WE ./path_to_the_west_texture
EA ./path_to_the_east_texture


F 220,100,123
C 25,255,10


1111111111
1E00000001
1000000001
1000000001
1000000001
1000010001
1000010001
1000010001
1000000001
1000000000
1111111111