NO ./img/imagen1.xpm
EA ./img/madera.xpm
SO ./img/grad1.xpm
WE ./img/teapot.xpm



F 0,0,0
C 255,255,255

1111111111
1E00000001
1000000001
1000000001
1000000001
1000011111
1000010001
1000010001
10000100001
1000000001
1111111111