NO ./img/imagen1.xpm
EA ./img/imagen1.xpm
SO ./img/imagen5.xpm
WE ./img/imagen1.xpm



F 90,10,10
C 90,90,90

1111111111
1S00000001
1000000001
1000000001
1000000001
1000010001
1000010001
1000010001
1000000001
1000000001
1111111111